A	A
ACCE	A CC E
ACHO	A CH O
ACHUM	A CH U M
ACHUMBA A CH U M B A
ACXHAN	A CXH A N
ACXO	A CX O
ADDITE	A D D I T E
ADIT	A D I T
ADITE	A D I T E
AEMENI	AE M E N I
AGAR	A G A R
AJO	A J O
AKHER	A KKH E R
AKHI	A KH I
AKHILCHU	A KH I L CH U
AKHOLLUM	A KH O LL U M
AKHOSH	A SH
AKHUING	A KH U I N G
AKHULY	A KH U L E
AKHUNNG	AKH U N G
AKHUYNG	A KH U I N G
AKKHATENA A KKH A T E N A
AKKHER	A KKH E R
AKKHOSH	A KKH O SH
AKUWAYUMBA	A K U W A I U M B A
ALAG	A L A G
ALCHINE	A L H CH I N E
AMAMANING	A M A M A N I N G
AMANA	A M A N A
AMANAMBA A M A N A M B A
AMEMO	A M E M O
AMES	A M E S
AMO A M O
AMOTA	A M O T A
AMUTU	A M U T U
AMUTUK	A M U T U K
AMUWA	A M U W A
AN A N
ANA	A N A
ANE	A N E
ANGARO	A N G A R O
ANUM	A N U M
APAAN	A P AA N
API	A P I
APU A P U
ASXHE	A SXH E
ATA	A T A
ATIMI	A T I M I
ATUMBA A T U M B A
ATUMBI	A T U M B I
ATUMBU	A T U M B U
ATUMU	A T U M U
AWA	A W A
AWARAMBA	A W A R A M B A
AWUYI	A W U I
AYAR	A I A R
AYASH	A I A SH
AYE	A I E
AYECHUMBAI	A I E CH U M B A I
AYET	A I E T
AYI A I
AYIDEEMI	A I I D E E M I
AYUWA	A I U W A
BA	B A
BAA	B A A
BAE	B AE
BAHLLKASHI	B A LL K A SH I
BAHLLT	B A H LL T
BAHLT	B A LL T
BAHNA	B A H N A
BAI	B A I
BALHAS	B A LL HA S
BALLDA	B A LL D A
BALLHAS	B A LL H A S
BAM	B A M
BAQI	B A Q I
BARAAN	B A R AA N
BARAN	B A R A N
BARING	B A R I N G
BASHA	B A SH A
BASPUR B A S P U R
BATHANAN	B A TH A N A N
BAYI	B A I I
BE	B E
BEHELL	B E H E LL
BEHLTUM	B E L H T U M
BERESPATE	B E R E S P A T E
BEROZGAAR	B E R O Z G AA R
BERUM	B E R U M
BESA	B E S A
BESAA	B E S AA
BESS	B E S
BI	B I
BIA	B I A
BIAASCCIMI	B I AA S CC I MI
BIASCCIMI	B I A S CC I M I
BICCA	B I CC A
BIKA B I K A
BIM	B I M
BISAARCHEN	B I S AA R CH E N
BIYA	B I A
BIYENUM	B I E N U M
BO	B O
BOKA	B O K A
BOKHABAR	B O KH A B A R
BOOTA	B OO T A
BOOTASIYA	B OO T A S I YA
BOTA	B O T A
BOTAN	B O T A N
BOTTA	B O TT A
BUDDU	B U DD U
BULL	B U LL
BULLE B U LL E
BULLHTUKI	B U LL H T U K I
BULYAINGE	B U L I A N G E
BUMBARAK	B U M B A R A K
BUSY	B I Z I
BUTT	B U TT
CARDBOARD	C A R D B O A R D
CCANDURARE	CC A N D U R A R E
CCE	CC E
CCHANDURARE	CCH A N D U R A R E
CCHEL	CC H E L
CCHELL	CC H E LL
CCHELLA	CC H E LL A
CCHERAAN	CCH E R AA N
CCHERAM	CC H E R A M
CCHERAN CC H E R A N
CCHEREMI CC H E R E M I
CCHEREMU	CCH E R E M U
CCHEREN	CCH E R E N
CCHOR	CCH O R
CCHURAM CCH U R A M
CCHUREN	CCH U R E N
CCHURIMI	CC H U R I M I
CCHURUMBA	CCH U R U M B A
CCHURUMU	CC H U R U M U
CCHUWA	CCH U W A
CHACHA	CH A CH A
CHACHAA	CH A CH AA
CHAGGORUM	CHH A GG O R U M
CHAKAATTO	CH A K AA TT O
CHAMARUTTO	CH A M A R U TT O
CHAP	CH A P
CHAPE	CHH A P E
CHASXHA	CHH A SXH A
CHAY	CH A I
CHERAAGGA	CCH E R AA GG A
CHEREMBA	CCH E R E M B A
CHHANGI	CHH A N G I
CHHAP	CHH A P
CHURUMU	CHH U R U M U
CONTACT	K O N T A K T
CXHA	CXH A
CXHAM	CXH A M
CXHENA	CXH E N A
CXHEW	CXH E W
CXICXIGHA	CX I CX I G A
CXOQA	CX O Q A
CXOQAA	CX O Q AA
DA	D A
DAA	D A A
DAAYA	D A A I A
DALL	D A LL
DALLA	D A LL A
DALLUM	D A LL U M
DAN	D A N
DANG	D A N G
DAPHERHKAN	D A P H E R H K A N
DARHKUT D A R H K U T
DDORO	DD O R O
DEE	D E E
DEEMBAI	D E E M B A I
DEEMBI	D E E M B I
DEEMI	D E E M I
DELL	D E LL
DELLA	D E LL A
DEPHERHKAN	D E PH E R H K A N
DIA	D I A
DICCA	D I CC A
DIS	D I S
DISHUYA D I SH U Y A
DIYA	D I A
DIYASHCHAN	D I A SH CH A N
DO	D O
DOCC	D O CC
DOCCA	D O CC A
DOGGOIKI	D O GG O I K I
DOHON	D O H O N
DOKOOSULJAAS	D O K OO S U L J AA S
DOMO	D O M O
DOMOMBU	D O M O M B U
DOMOMBUASCCUMU	D O M O M B U AA S CC U M U
DOMOOMU	D O M O O M U
DOMOSTER	D O M O S T E R
DORO	D O R O
DOROING	D O R O I N G
DOST	D O S T
DOVA	D U V A
DUA	D U A
DUAA	D U AA
DUAM	D U A M
DUCCAA	D U CC AA
DUCCHUMU	D U CCH U M U
DUCHUA	D U CHH U A
DUCHUWA	D U CHH U W A
DUMUCH	D U M U CC
DUNESH	D U N E SH
DUNIA	D U N I A
DUNYA	D U N I A
DURDANA	D U R D A N A
DUUS	D U U S
DUUSUMBI	D UU S U M B I
DUVA	D U V A
DUWALCHEMEN	D U W A L CH E M E N
DUWALCHIMI	D U W A L H CH I M I
DUWALCHUMU	D U W A L CH U M U
DUWALHCHEMEN	D U W A L CH E M E N
DUWALHCHIMI	D U W A L CH I M I
DUWALI	D U W A L I
DUWALIMI	D U W A LL I M I
DUWALLASCCEMEN D U W A LL AA S CC E M E N
E	E
ECHA	E CH A
ECHAM	E CH A M
ECHAMBA	E CH A M B A
ECHUMA	E CH U M A
ECHUMBAI	E CH U M B A I
EKHARA	E KH A R A
EKHARINGA	E KH A R I N G A
ELJA	E L J A
ELJASENUMBI	E L J A S E N U M B I
ESARCHAM	E S A R CH A M
ET	E T
ETA	E T A
ETAA	E T AA
ETAAS	E T A AA S
ETAMAM	E T A M A N
ETAS	E T A S
ETUMBI	E T U M B I
ETUMBU	E T U M B U
EYA	E Y A
FANNG	F A NG
FAS	F A S
FAT	F A T
FILHAAL	F I L AA LL
FILHAL	F I L A LL
FIS	F I S
GA	G A
GAANING	G A A N I N G
GADAERO	G A D A E R O
GAGANUM	G A G A N U M
GALI	G A L I
GALLU	G A LL U
GAMBURI	G A M B U R I
GAMBURIMO	G A M B U R I M O
GANDI	G A N D I
GARE	G A R E
GARI G A R I
GAROOM	G A R UU M
GARUUM	G A R UU M
GATT	G A TT
GATTUNZ	G A TT U N Z
GE	G E
GERMANY J A R M A N I
GGA	GG A
GGAAN	GG AA N
GGAAN GG AA N
GGAFA	GG A F A
GGAN	GG A N
GGARING	GG A R I N G
GHA	GH A
GHASXHAP	G A SXH A P
GILHTA G I L H T A
GIRAASHUMBAI	G I R AA SH U M B A I
GIRINJ	G I R I N J
GIRMINAAS	G I R M I N AA S
GIRMINAS	G I R M I N A S
GIRMINCHUMBAI G I R M I N CH U M B A I
GIYAXCUMBIYE	G I Y A CX U M B I Y E
GO	G O
GOCHAMBA	G O CH A M B A
GOGGA	G O GG A
GOMES	G O M E S
GOMOOS G O M OO S
GON	G O N
GOO	G OO
GOSERA	G O S E R A
GOSQAYAMBA	G O S Q A I A M B A
GOSULLE	G O S U LL E
GUAACXA	G U AA CX A
GUAN	G U A N
GUANA	G U A N A
GUAWAYA G U W A Y A
GUCCHARCHUMBAI	G U CCH A R CH U M B A I
GUCHAM	G U CH A M
GUCXATTINGA G U CX A TT I N G A
GUDELLUMAM	G U D E LL U M A N
GUHLLTAING	G U LL H T A I N G
GUKE	G U K E
GUKHAR	G U KH A R
GULABI	G U L A B I
GULIAB	G U L I A B
GUNZ	G U N Z
GUSAY	G U S E
GUSE	G U S E
GUTE	G U T E
GUTE G U T E 
GUTEY G U T E 
GUWANUMBA G U W A N U M B A
GUWARUMBA G U W A R U M B A
GUWAYA	G U W A I A
GUWAYUMBA	G U W A I U M B A
GUYA	G U Y A
GUYATES G U Y A TT E S
HAALLE	H A A LL E
HAINN	H A I N
HAL	H A L
HALLAA	H A LL AA
HALLAES	H A LL AE S
HALLE H A LL E
HALLES	H A LL E S
HALLESEN	H A LL E S E N
HAMESHA H A M E SH A
HAN H A N
HAR H A R
HARANGA	H A R A N G A
HARYASXH	H A R Y A SXH
HAWAAZAN	H A W AA Z A N
HAWAAZING	H A W AA Z I N G
HAZIR	H A Z I R
HEK	H E K
HEN	H E N
HEPULLHTUK H E P U LL H T U K
HIR H I R
HIREN	H I R E N
HO	H O
HOI	H O I
HOLA	H O L A
HOLLA	H O LL A
HOLLUM	H O LL U M
HORGO	H O R G O
HUECXA	H U E CX A
HUN	H U N
IN	I N
INTERNSHIP	I N T E R N SH I P
ISHPIT	I SH P I T
ISXHQA	I SXH Q A
ISXHQAM	I SXH Q A M
ITA	I T A
JA	J A
JAA	J AA
JAACCE	J AA CC E
JAGGA	J A GG A
JAGGACHI	J A GG A CH I
JAGGANNG	J A GG A NG
JAN	J A N
JAVAAYU	J A V A A I U
JAWAANE	J A W AA N E
JAWAYU J A W A I U
JEET	J E E T
JIMALL	J I M A LL
JIRMANI	J I R M A N I
JUA	J U A
KA K A
KAAT	K AA T
KAATT	K AA TT
KAM	K A M
KAMAN	K A M A N
KARACHI	K A R A CH I
KATTAR K A TT A R
KHAASXH	KH AA SXH
KHAELLA	KH A E LL A
KHAI	KH A I
KHAKARUMAM KH A K A R U M A N
KHAKKARUMAM KH A K A R U M A N
KHASXH	KH A S CX
KHATT	KH A TT
KHATTA	KH A TT A
KHENAE	KH E N AE
KHENE	KH E N E
KHITA	KH I T A
KHOSH	KH O SH
KHUSHAN KH U SH A N
KITTORI K ITT O R I
KKHABAR	KKH A B A R
KKHABR	KKH A B A R
KOLLO	K O LL O
KYAKI	K I A K I
LAGA	L A G A
LALA	L A L A
LAY	L A I
LE	L E
LEKIN	L E K I N
LEY	L E
LIBRARY	L I B R A R I
LIP	L I P
LLAYEN	LL E N
LLAYUMAN	LL A I U M A N
LLOLL	LL O LL
MA	M A
MAA	M AA
MAATO	M AA T O
MAATTO M AA TT O
MALL	M A LL
MANI	M A N I
MANISXH	M A N I SXH
MANUMBI M A N U M B I
MANUMBU M A N U M B U
MANUNDUAA	M A N U N D U AA
MASQARA	M A S Q A R A
MAYA	M A Y A
MAYIMI	M A I I M I
MAYUNDUA	M A I U N D U A
MAZA	M A Z A
MEL	M E L
MEN	M E N
MENA	M E N A
MENE	M E N E
MES	M E S
MESSAGE	M E S A G E
METI	M E T I
MI	M I
MISHAASKI	M I SH AA S K I
MIYAMBA	M I A M B A
MO	M O
MOBILE	M OO B I L E
MOGGA	M O GG A
MOGHA	M O GG A
MOMES	M O M E S
MOMESE	M O M E S E
MOMO	M O M O
MOMOGGA M O M O GG A
MOTUNDULLUM	M O T U N D U LL U M
MS M S
MUALLUMBU	M U A LL U M B U
MUCHAR M U CHH A R
MUCXHAN	M U CX A N
MUHLCHI M U H L CH I
MUKAATT M U K AA TT
MULL	M U LL
MUSXHE	M U SXH E
MUSXHIMBA M U SXH I M B A
MUSXHIYA	M U SXH I Y A
MUWA	M U W A
MUWALLUMBU	M U W A LL U M B U
MUWASHIMBU	M U W A S H I M B U
MUWASHIYAMAM	M U W SH I Y A M A M
MUYI	M U I
NA	N A
NAA	N AA
NACHAAR N A CH AA R
NAE N AE
NAECCUM	N AE CC U M
NAEGGA	N AE GG A
NANA	N A N A
NAQAABEL N A Q AA B E L
NAT	N A T
NAWALL	N A W A LL
NE	N E
NEAASCCUMU	N E AA S CC U M U
NEE	N E E
NEGA	N E G A
NEGGA	N E GG A
NEH	N E
NEINGEA	N E I N G E A
NEINGYA N E I N G I A
NEKAATT	N E K AA TT
NEMBAI	N E M B A I
NEMBI	N E M B I
NEMBIASCCIMI	N E M B I AA S CC I M I
NEMBU N E M B U
NEME	N E M E
NEMI	N E M I
NEMU	N E M U
NESXH	N E SXH
NET	N E T
NETE	N E T E
NETEY	N E T E
NETT	N E TT
NEWS	N E W S
NEYAMAM	N E Y A M A M
NICCHU	N I CCH U
NIDELL	N I D E LL
NIGI	N I G I
NIMA	N I M A
NISXHI	N I SXH I
NITHI	N I T H I
NIWALL	N I W W A LL
NIYA	N I A
NIYAA	N I A A
NNYU N Y U 
NOKO	N O K O
NOMO	N O M O
NOMOT	N O M O T
NOSAR	N O S A R
NOT	N O T
NOYU	N O Y U
NUHARYA	N U A R I A
NUHURUTT	N U H U R U TT
NUKKHA	N U KKH A
NUME	N U M E
NUMUMA	N U M U M A
NUMUWASH	N U M U W A SH
NUPISHA	N U P I SH A
NUQAS	N U Q A S
NUSXHU	N U SXH U
NUVELL	N U V E L L
NUWELL	N U W E LL
NYU	N I U
OFFICE	O F I S
OMOOS	O M OO S
OPTION  O P SH A N
OS	O S
PAISA	P A I S A
PAQO	P A Q O
PARESHAN	P A R E SH A N
PARHAAI P A R H AA I
PARHAI P A R H A I
PENAN	P E N A N
PETTEK	PH E TT E K
PHAANUUS	PH AA N UU S
PHAPHARA	PH A PH A R A
PHAT	PH A T
PHOTO	PH O TT O
PINDI	P I N D I
PRESHAANI	P A R E SH A A N I
QABEL	Q A B E L
QAQ	Q A Q
QAUV	Q A U V
QAW	Q A W
QOW	Q O W
RAI R A I
REPORTER	R E P O R T E R
SAAN	S AA N
SAATTIK	S AA TT I K
SAEGGA S AE GG A
SAF S A F
SAHI	S A H I
SAM	S A M
SATTIK	S A TT I K
SAYILA	S A I I L A
SE	S E
SEEMBAYI	S E E M B A I I
SEGGA	S E GG A
SENAA	S E N A A
SENAS	S E N A S
SENEN	S E N E N
SENI	S E N I
SENUMAM	S E N U M A N
SENUMBI S E N U M B I
SENUMBU	S E N U M B U
SENUMU	S E N U M U
SHAAM	SH A A M
SHAAMA	SH A A M A
SHAASKI	SH AA S K I
SHAGHETAN	SH A G H E T A N
SHAHAR	SH A H A R
SHAKAR	SH A K A R
SHAM	SH A M
SHE	SH E
SHECHUMBI	SH E CH U M B I
SHEI	SH E I
SHENG	SH E N G
SHOA	SH O A
SHOHLLTY	SH O LL T E
SHOWA	SH O W A
SHUA	SH U A
SHUAA	SH U AA
SHUKURU SH U K U R U
SHUM SH U M
SHUMSHER SH U M SH E R
SHUMSHERE	SH U M SH E R E
SIMBA	S I M B A
SIYA	S I Y A
SIYAMA S I A M A
SOCIAL	S O C I A L
SXHE	SXH E
SXHELI	SXH E L I
SXHICXAM	SXH I CX A M
TAAP	T A A P
TAENE	T AE N E
TAI T A I
TAINGE	T A I NG E
TASVEERAN	T A S V E E R A N
TATA	T A T A
TATI	T A T I
TAURUMA	T A U R U M A
TAUSA	T A U S A
TAYILLHCC	T A I I LL H CC
TE	T E
TEGGA	T E GG A
TEYTTE T E Y A TT E
THAMENE	TH A M E N E
THAPE	TH A P E
THAPPE TH A P E
THATHALL	TH A TH A LL
THEEK	TTH E E K
THORO	TTH O R O
THOROMO TTH O R O M O
THOSXH	TH O SXH
THUM	TH U M
THUMAN TH U M A N
TIK T I K
TOLLUM	T O LL U M
TOURNAMENT	T O U R N A M E N T
TRAUV	T R A W
TRAW	T R A W
TTHOROMO TTH O R O M O
TTHUKO	TTH U K O
TTHUKOO TTH U K O
TTHUKOGA	TTH U K O G A
TTINZ	TT I N Z
TTIR	TT I R
TUNI	T U N I
TUNICHA T U N I CH A
TUNICHI	T U N I CH I
TUNN	T U N
UCXHAN	U CXH A N
ULE U L E
ULLE	U LL E
ULLE U LL E
UN	U N
USXHE	U SXH E
UWA	U W A
UYI	U I
VAE	V A E
VAEGGA	V AE GG A
VE V E
WAGERA	W A G E R A
WAL	W A L
WALCHIMI	W A L H CH I M I
WALHCHIMI	W A L H CH I M I
WALI	W A L I
WALIMI	W A L I M I
WALLHTE	W A LL H T E
WALLUMBI	W A LL U M B I
WARCCA	W A R CC A
WASHCHEMEN	W A SH CH E M E N
WASHCHUMAAN	W A SH CH U M AA N
WASHI	W A S H I
WASHIAASCCEMEN	W A S H I AA S CC E M E N
WASHIAASCCIMI	W A S H I AA S CC I M I
WASHIMAAN	W A S H I M AA N
WASHIMI	W A SH I M I
WAAW	W AA W
WAW	W A W
WAWE	W A W E
WAWEN	W A W E N
XAKUN	X A K U N
XAKUNE	X A K U N E
XAPAXAP	X A P A X A P
XARURAT	X A R U R A T
XO	X O
XOAAS	X O AA S
XONNG	X O NG
XOSXH	X O SXH
YA	Y A
YAAR	Y AA R
YAARA	Y AA R A
YAARBULLHTUK	Y AA R B U LL H T U K
YAH	Y A
YAHLLTARE	Y A H LL T A R E
YAHLLTARY	Y A HLL T A R E
YAKALLA	Y A K A LL A
YANAA Y A N AA
YANUMBA	Y A N U M B A
YANUMBU Y A N U M B U
YARA	Y A R A
YARBULLHTUK	Y A R B U LL H T U K
YARY	Y A R I
YASENA	Y A S E N A
YATE	Y A TT E
YATISE	Y A TT I S E
YATTA	Y A TT A
YATTE Y A TT E
ZALI	Z A L I
ZALIM	Z A L I M
ZALL	Z A LL
ZEHN	Z E H N
