ءی	i
آء	A
آءینده	A i n dd A
آجاتا	A dZ A td A
آجاتے	A dZ A td e
آخرکیوں	A x y r k i o~
آوروں	A v y r o~
آوزوں	A v y z o~
آگءے	A g y e
آگر	A g y r
ا	m A
اءیر	i r
اب y b 
اجازت i dZ A z y td 
اجناس y dZ n A s 
ادارۂ	y dd A r q
اداشت	y dd A S td
اس U s 
اس i s 
استحصال i s td i h s A l 
اسحاق i s h A q 
اسحق	i s h y q
اسٹریٹیجک	i s t' y r i t' e dZ i k
اضافه i z A f A 
اعضاء	y z A
اغاز	y 7 A z
اغواء	i 7 v A
افراد y f r A dd 
افظار	y f z A r
اقتدار i q td i dd A r 
الخلا	U l x y l A
الدین	U dd dd i n
الرفق	y l y r f i q
الشان	S A n
الصرف	s i r i f
الناس	U l i s
النحو	U l n y h u
الے	U l e
اناج y n A dZ 
انتهاء	i n td y h A
انسٹی	i n s t' i
انٹرنیشل	i n t' y r n e S y l
انڈراءیڈ	i n d' y r A i d'
انڈسٹری i n d' y s t' i r i 
انڈیز	i n d' i z
انگھنے	y N n e
اوبر	o b y r
اور O r 
اور o r 
اوران	o r A n
اوراپنے	o r A p n e
اوراینجل	o r Y n dZ y l
اوگرا	o g y r A
اٹھاره	U t'h A r A
اپنا y p n A 
اچھنبے	U tSh i m b e
ایشن	e S y n
بادشا	b A dd i S A
بالاخر	b A l A x y r
بانٹاجا	b A n t' A dZ A
بتلاهے	b y td l A h e
بجاکر	b y dZ A k y r
بحثیت	b y h s i j y td
بحیرے	b y h i r e
بدلتاهے	b y dd y l td A h e
برابرتنخوا	b y r A b y r td n y x A
برقراری	b y r q U r A r i
بلتت	b y l td y td
بلکھڑ	b l i kh y r'
بنانا b y n A n A 
بنایا b y n A j A 
بوڑھاهو	b o r'h A h o
بڑاتے	b y r' A td e
بڑی b y r' i 
بھر bh y r 
بھلاء	bh U l A
بھی bh i 
بیجھے	b i dZh e
بیس b i s 
بیٹابیٹی	b e t' A b e t' i
بیچ b i tS 
بیچار	b e tS A r
بیھٹک	b e y t' k
بےلاحقی	b e l A h y q i
بےچارا	b e tS A r A
ت	td
تاکه td A k e 
تباه td y b A 
تجویدالقرآن	td y dZ v i dd A l q U r A n
ترقی td y r y q q i 
تصورکرکے	td y s u r k y r k e
تنخوا	td n y x A
تهه	td y h A
تواب	td y v A b
توسونے	td o s u n e
تونهیں	td i~
تک td U k 
تک td y k 
تیونسی	td i o n s i
جاءے dZ A e 
جاتااور	dZ A td A o r
جاتاهے	dZ A td A h e
جارحیت	dZ A r e h y j y td
جارها	dZ A r y h A
جارهی	dZ A r y h i
جاسویا	dZ A s y v i j A
جاسکتا	i s k td A
جذبا	dZ y z y b A
جران	dZ y r A n
جس dZ i s 
جنجھور	dZ y n dZh o r
جهنوں	dZ y h n o~
جوده	dZ u dd A
جولیٹ	dZ u l i t'
حاسدا	h A s i dd A
حالات	h A l A td
حدتک	h y dd dd y td k
حقانیه	h y q A n i j A
حققین	h y q q i q i n
حقو	h y q u
حقیقین	h y q i q i n
حوصلی	h y v y s l i
حکمرانوں h U k m y r A n o~ 
حکومت h U k u m y td 
حکومت h y k u m y td 
حیتوں	h i j y td o~
خاص x A s 
خوا	x A
خوابیں	x i~
خودکفیل x U dd k y f i l 
خوشحال x U S h A l 
خوفناک	x u f y n A k
خیبرپختونخوا	x Y b y r p U x td u n y x A
خیرجب	i r dZ y b
داریا	dd A r i j A
داغ	dd A 7
داقبال	dd A q y b A l
دبءی	dd y b i
دداشت	dd U dd A S td
درکا	dd y r k A
دریاءے	dd r i j A e
دعاوں	dd o~
دنیا dd U n j A 
دهانی	dd y h A n i
دواں	dd A~
دودھ dd u ddh 
دورکے	dd u r k e
دوگنی	dd o g n i
دی dd i 
دیءے	dd i e
دیابھابی	dd i j A bh A b i
دیاهے	dd i j A h e
دیتاهے	dd i j y td A h e
دیٹ	dd e t'
دیکنھے	dd i k e
دیکھاوا	dd e kh A v A
دیکھایاجاتاهے	dd e kh A j A dZ A td A h e
ر	r
راجستھان	r A dZ i s tdh A n
رهتاهے	r y h td A h e
روکاوٹ	r o k A v y t'
رکھااور	r y kh A o r
رکھاهےاس	r y kh A h e i s
زراعت z i r A y td 
زرداری	z y r dd A r i
زرعی z y r i 
زرمبادله z y r e m U b A dd y l A 
س	s
ساب	s A b
ساتھ s A tdh 
سازی	s A z i
سالهپانچ	s A l y h p A n tS
سبزیاں s y b z i j A~ 
سسے	s i s e
سطع	s y td td e
سلیب	i b
سنبھالتاهے	s n i bh A l td A h e
سنجیدگی s y n dZ i dd y g i 
سنوواءٹ	s y n O v A i t'
سنڈریلا	s y n d' y r i l A
سوچ s o tS 
سوچنا s o tS n A 
سکوبی	s y k o b i
سکیں s y k e~ 
سکے s i k k e 
سے s e 
ش	S
شءیرز	S y i r z
شرکا	S y r k A
شریڈل	i d' y l
شعبے S U b e 
شنواری	S y n v A r i
شهروں S y h r o~ 
شهیدطفیل	S y h i dd e td i f i l
شوشل	S o S y l
شوگر S u g y r 
شکنی	S y k n i
صاحب s A h i b 
صحراءے	s U h y r A e
صرف s i r f 
صرف s i r y f 
صرف s y r f 
صرف s y r y f 
صلاحتیں	s y l A h y td i~
صنعتوں s y n y td o~ 
صنعتکار s y n y td k A r 
ضرورت z U r u r y td 
طالبانوں	td A l y b A n o~
طبقه td y b q A 
طرف td y r f 
طلباء	td y l b A
طور td O r 
طور td o r 
طور td u r 
ظهبی	z y h b i
فتاوا	f td A v A
فروانی	f y r v A n i
فروخت f y r O x td 
فری f r i 
فریقه	f y r i q A
فقهه	f U q y h A
فلور f y l O r 
فوتگی	f O td y g i
فور	f o r
فوقتا	f O q y td A
ق	q
قلعلے	y l e
قهقه	q y h q A
قوله	q u l A
قی	q i
لءیے	l y i e
لءے l i e 
لاءزنگ	l A i z i N
لاتا l A td A 
لڑنے	l y r' n e
لکھنو	l i kh y n o
لیں l e~ 
لیں l i~ 
لے l e 
مارکیٹ m A r k i t' 
مال m A l 
مسءلے m y s y l e 
مشوره m y S v y r A 
ملز m i l z 
ملک m U l k 
ملک m i l k 
ملک m y l i k 
ملکی m U l k i 
ممالک m y m A l i k 
منصوبه m y n s u b A 
میرا m i r A 
میں m Y 
میں m Y~ 
میں m e 
میں m e~ 
ناتجربه	n A td y dZ y r b A
ناجلدی	n A dZ y l dd i
ناقصں	A~
نخواسته	n y x i s td A
نطروں	n e td y r o~
نظرقصور	n y z y r q s u r
نقطع	n q y td td e
نوشهره	n o S y h r A
نوٹیفیکیشن	n o t' i f Y k e S y n
نوں	n o~
نکڑپر	n k y r' p y r
نکیلا	n k e l A
نگے	m y N g e
نیواڈا	n i v A d' A
نیکٹا	n i k t' A
ه	m A
هانکتے	h A n k td e
هراس	h y r A s
هرصورت	h y r s u r y td
هسپتالو	h y s p y td A l o
هلکا	h i l k A
هلکی	h i l k i
همیں h y m e~ 
هنسی	h y n s i
هنوستان	h n v y s td A n
هوء	h u
هوتاتھا	h o td A tdh A
هوتاهے	h o td A h e
هوتےکافر	h o td e k A f y r
هورهی	h o r y h i
هوسکی	h o s k i
هوٹلوں	h o~
هوکھیل	h o kh i l
هوگا h o g A 
هٹادیں	h y t' A dd i~
هکا	h k A
هیں Y~ 
هیں h Y~ 
هے Y 
هے h Y 
واءبر	v A i b r
وادء	v A dd
واقفی	v A q y f i
والے v A l e 
وانصاف	v A n y s A f
وبیش	m u b e S
وتعالی	v y td A l i
وجودهےاس	v y dZ u dd y h e i s
وجودهےایک	v y dZ u dd y h e Y k
وحیا	v y h j A
ورزیاں	v y r z i j A~
وزیرخزانه v y z i r e x y z A n A 
وقتا	v y q td A
وهند	m o h y n dd
وں	o~
ٹ	t'
ٹهوهر	t' y h o h y r
ٹویٹ	t' v Y t'
ٹیوٹ	t' i o t'
ٹیپیکل	t' Y p Y k y l
ٹیکجوس	t' Y k y dZ u s
ٹیکسٹاءل t' Y k s t' A i l 
پختونخوا	p U x td u n y x A
پر p U r 
پر p y r 
پردیکھا	p y r dd e kh A
پردے	p y r dd e
پرپٹکتا	p y r p y t' k td A
پرپیوند	p y r p i j u n dd
پنجگور	p y n dZ y g o r
پنوکیوهر	p y n O k i o h y r
پهیلاءی	p y h i l A i
پهیه p y h i j A 
پورٹرز	p o r t' y r z
پولیسنگ	p o l Y s y N
پوچھاکه	p u tSh A k A
پٹانگ	p y t' A N
پچیده	p i tS i dd A
پچیدگیاں	p i tS i dd y g A~
پڑجاءے	p y r' y dZ A e
پھربھی	ph y r bh i
پھل ph y l 
پیدا p Y dd A 
پیپلز	p Y p y l z
چ	tS
چاءیے	tS A i e
چاهیءں	tS A h i A~
چلاگیا	tS y l A g i j A
چلتا tS y l td A 
چپرار	tS U p y r A r
چھن	tSh y n
چھٹیوں	tSh y t' i o~
ڈاءنوساروں	d' A i n v y s A r o~
ڈار d' A r 
ڈاکڑ	d' A k y r'
ڈاکڑکو	d' A k y r' k o
کا k A 
کااحساس	k A i s
کاروءی	k A r u i
کام k A m 
کاپلندا	k A p y l y n dd A
کر k y r 
کرارهے	k y r A r y h e
کراچ	k y r A tS
کربتایا	k y r b y td A j A
کرتا k U r td A 
کردو	k y r dd o
کررهے k y r r y h e 
کرنے k y r n e 
کروڑ k y r O r' 
کسان k i s A n 
کسانوں k i s A n o~ 
کنار	k y n A r
کنسر	k y n s y r
که k e 
کهاتیری	k y h A td i r i
کهاجاتاهے	k y h A dZ A td A h e
کهه	k y h A
کو k o 
کوء	k o
کوءیسچن	k o i s tS y n
کواگر	k v A g y r
کوایسی	Y s i
کوجک	k o dZ y k
کورسسز	k o r y s s i z
کونفلکٹ	k o n y f y l k t'
کوچاهءے	k o tS A h y e
کھرونچوں	kh y r u n tS o~
کی k i 
کیاجاتاهے	k i j A dZ A td A h e
کیوںکر	k i o~ k y r
کے k e 
کےلءیے	k e l y i e
کےچار	k e tS A r
گاڑھتی	g A r'h td i
گاکه	g A k A
گذشته	g U z S td A
گراس	g y r A s
گربا	g y r b A
گرگءی	g y r g y i
گریجوءٹس	g y r i dZ u i t' s
گلبدین	g U l b y dd i n
گلوکا	g U l o k A
گلیشءرز	g y l e S i y r z
گنگناءیں	g y N g y n A i~
گیااور	g i j A o r
گیوزیپی	g i o z i p i
گیے	g i e
یا j A 
یاداداشت	j A dd A dd A S td
یافته j A f td A 
یانوجوان	j A n O dZ y v A n
یاکھیل	j A kh i l
یه j e 
یونینز	j u n i n z
یکجا	m Y k y dZ Ae
یں	i~
!SIL	SIL
